######################################
#....................................#
#..S...#......................#......#
#......#......................#......#
#.............................#......#
#....................................#
#....................................#
#..............#.....................#
#............#.......................#
#..........#.........................#
#....................................#
#.....................#..........#...#
#.....................#....E.....#...#
#.....................#..........#...#
#....................................#
######################################